Seed used: 975
--------------------
SFFFFFFF
HFFFFFFF
FFFFFFFF
FFHFFFFF
FHFHFFHF
FFFFFFHF
FFFFFFFF
FFFFFFFG
